3 3 3 3 3 3 3 3 3 3 3 3 3 3 3 3
3 3 3 3 3 3 3 3 3 3 3 3 3 3 3 3
3 3 5 10 10 10 10 10 10 10 10 10 10 10 10 10
3 3 6 0 0 0 0 0 0 0 0 0 0 0 0 0
3 3 6 0 0 0 0 0 0 0 0 0 0 0 0 0
3 3 6 0 0 0 0 0 0 0 0 0 0 0 0 0
3 3 6 0 0 0 0 0 0 0 0 0 0 0 0 0
3 3 6 0 0 0 0 0 0 0 0 0 0 0 0 0
3 3 6 0 0 0 0 0 0 0 0 0 0 0 0 0
3 3 6 0 0 0 0 0 0 0 0 0 0 0 0 0
3 3 6 0 0 0 0 0 0 0 0 0 0 0 0 0
3 3 6 0 0 0 0 0 0 0 0 0 0 0 0 0
3 3 6 0 0 0 0 0 0 0 0 0 0 0 0 0
3 3 6 0 0 0 0 0 0 0 0 0 0 0 0 0
3 3 6 0 0 2 2 2 2 2 2 2 2 2 2 2
3 3 6 2 2 2 2 2 2 2 2 2 2 2 2 2
