20 20 20 20 20 20 20 20 20 20 20 20 20 20 20 20
20 21 20 20 20 20 20 20 20 20 20 20 20 20 20 20
20 20 20 20 20 20 20 20 20 20 20 20 20 20 20 20
20 20 20 20 20 20 20 20 20 20 20 20 20 20 20 20
20 20 20 20 20 20 20 20 20 20 20 20 20 20 20 20
15 15 15 15 15 15 15 15 15 15 15 15 15 15 15 15
12 12 12 12 12 12 12 12 12 12 12 12 12 12 12 13
12 12 12 12 12 12 12 12 12 12 12 12 12 12 12 13
12 12 12 12 12 12 12 12 12 12 12 12 12 12 12 13
12 12 12 12 12 12 12 12 12 12 12 12 12 12 12 13
12 12 12 12 12 12 12 12 12 12 12 12 12 12 12 13
12 12 12 12 12 12 12 12 12 12 12 12 12 12 12 13
12 12 12 12 12 12 12 12 12 12 12 12 12 12 12 13
12 12 12 12 12 12 12 12 12 12 12 12 12 12 12 13
14 14 14 14 14 14 14 14 14 14 14 14 14 12 12 13
14 14 14 14 14 14 14 14 14 14 14 14 14 12 13 13