20 20 20 20 20 20 20 20 20 20 20 20 20 20 20 20
20 20 20 20 20 20 20 20 20 20 20 20 20 20 21 20
20 20 20 20 20 20 20 20 20 20 20 20 20 20 20 20
20 20 20 20 20 20 20 20 20 20 20 20 20 20 20 20
20 20 20 20 20 20 20 20 20 20 20 20 20 20 20 20
20 20 19 15 15 15 15 15 15 15 15 15 15 15 15 15
20 20 16 12 12 12 12 12 12 12 12 12 12 12 12 12
20 20 16 12 22 12 22 12 22 12 22 12 12 12 12 12
20 20 16 12 22 12 12 12 12 12 12 12 12 12 12 12
20 20 16 12 12 12 12 12 12 12 22 12 12 12 12 12
20 20 16 12 22 12 22 12 22 12 22 12 12 12 12 12
20 20 16 12 12 12 12 12 12 12 12 12 12 12 12 12
20 20 16 12 12 12 12 12 12 12 12 12 12 12 12 12
20 20 16 12 12 12 12 12 12 12 12 12 12 12 12 12
20 20 16 14 14 14 14 14 14 14 14 12 12 14 14 14
20 20 16 14 14 14 14 14 14 14 14 12 12 14 14 14