24 26 24 27 24 26 24 24 26 26 26 26 26 26 26 26
24 26 24 27 24 26 24 24 26 24 24 24 24 24 24 26
24 26 24 27 24 26 24 24 26 24 27 27 27 27 24 26
24 26 24 24 24 26 24 24 26 24 24 27 24 27 24 26
24 26 24 24 26 26 24 24 26 26 24 27 24 27 24 26
24 26 24 24 26 24 24 24 24 26 24 27 24 27 24 26
24 26 24 24 26 24 27 27 24 26 24 27 24 27 24 24
24 26 24 24 26 24 27 27 24 26 24 27 24 27 24 24
24 26 24 24 26 24 24 24 24 26 24 27 24 27 27 27
24 26 24 24 26 26 24 24 26 26 24 27 27 27 24 24
24 26 24 24 24 26 28 28 26 24 24 24 24 24 24 24
24 26 24 24 24 26 28 28 26 24 24 24 26 26 26 26
24 26 24 27 24 24 24 24 24 24 27 24 26 24 24 26
24 26 24 24 24 24 27 27 24 24 24 24 24 24 24 26
24 26 26 26 26 26 26 26 26 26 26 26 26 26 26 26
24 24 24 24 24 24 24 24 24 24 24 24 24 24 24 24