26 26 26 26 26 26 26 26 26 26 26 25 24 24 26 24
26 24 24 24 24 25 26 24 24 24 24 24 24 24 26 24
26 24 24 24 24 24 26 24 24 24 24 24 24 24 26 24
26 24 26 24 24 25 26 24 24 26 24 27 27 24 26 24
26 24 26 24 24 24 26 24 24 26 24 27 27 24 26 24
26 24 26 24 24 25 26 24 24 26 24 27 27 24 26 24
24 24 26 24 24 24 26 24 24 26 24 27 27 24 26 24
24 24 26 24 24 25 26 24 24 26 24 27 27 24 26 24
24 24 26 24 24 24 24 24 24 26 24 27 27 24 26 24
24 24 26 24 27 27 27 27 24 26 24 27 27 24 26 24
26 24 26 24 27 24 24 27 24 26 24 27 27 24 26 24
26 24 26 24 27 24 24 27 24 26 24 27 27 24 26 24
26 24 26 24 27 27 27 27 24 26 24 27 27 24 26 24
26 24 26 24 24 24 24 24 24 26 24 24 24 24 26 24
26 26 26 26 26 26 26 26 26 26 26 26 26 26 26 24
24 24 24 24 24 24 24 24 24 24 24 24 24 24 24 24