24 27 24 26 26 26 26 27 27 26 26 26 26 24 27 24
27 24 27 26 24 24 24 24 24 24 24 24 26 27 24 27
24 27 24 26 24 27 24 24 24 24 27 24 26 24 27 24
27 24 27 26 24 24 27 24 24 27 24 24 26 27 24 27
24 27 24 26 25 25 27 24 24 27 25 25 26 24 27 24
27 24 27 26 27 27 27 27 27 27 27 27 26 27 24 27
24 27 24 26 25 25 24 24 24 24 25 25 26 24 27 24
27 24 27 26 27 24 24 27 27 24 24 27 26 27 24 27
24 27 24 26 25 25 27 24 24 27 25 25 26 24 27 24
27 24 27 26 27 24 24 27 27 24 24 27 26 27 24 27
24 27 24 26 25 25 24 24 24 24 25 25 26 24 27 24
27 24 27 26 27 27 27 27 27 27 27 27 26 27 24 27
24 27 24 26 24 25 27 24 24 27 25 24 26 24 27 24
27 24 27 26 24 24 27 24 24 27 24 24 26 27 24 27
24 27 24 26 24 24 24 24 24 24 24 24 26 24 27 24
27 24 27 26 26 26 26 27 27 26 26 26 26 27 24 27