26 24 26 26 26 26 26 26 24 24 24 24 26 24 26 24
26 24 26 24 24 24 24 26 24 27 27 24 26 24 26 24
26 24 26 24 26 26 26 26 24 27 27 24 26 24 26 24
26 24 26 24 26 24 24 24 24 27 27 24 26 24 26 24
26 24 26 24 26 24 24 24 24 24 24 24 26 24 26 24
26 24 26 24 24 24 26 26 26 26 26 26 26 24 26 24
26 24 26 24 24 24 26 24 27 24 24 24 24 24 26 24
26 24 26 24 26 24 26 27 24 26 26 26 26 26 26 24
26 24 26 24 26 24 26 24 27 24 24 24 24 27 26 24
26 24 26 24 26 24 26 26 26 26 26 26 26 24 26 24
26 24 26 24 26 24 27 24 27 24 27 24 27 24 26 24
26 24 24 24 26 27 24 27 24 27 24 27 24 27 26 24
26 24 26 26 26 26 26 26 26 26 26 26 26 26 26 24
26 24 24 26 27 24 27 24 27 24 27 24 27 24 26 24
26 27 24 27 24 27 24 27 24 27 24 27 24 27 26 24
26 26 26 26 26 26 26 26 26 26 26 26 24 24 26 24